##########################################################        #############
#                                      #                                      #
#                                      #                                      #
#                                      #                                      #
#                                                                             #
#                                                                              
#                                                                              
#                                                                              
#                                                                             #
#                                      #                                      #
#                                      #                                      #
#                                      #                                      #
#######       #################################################               #
#                                      #                      #               #
#                                      #                                      #
#                                      #                      #               #
#                                      #                      #               #
#                                      #                      #################
#                                      #                                      #
#                                      #                                      #
#                                      #                                      #
#                                      #                                       
#                                      #                                      #
#                                      #                                      #
###############################################################################