###############################################################################
#                                                                             #
#                                                                             #
#                                                                             #
#                                                                             #
#                                                                             #
#                                    a                                        #
#                                   aaa                                       #
#                                  aaaaa                                      #
#                                   aaa                                       #
#                                    #                                        #
#                                    #                                        #
#                                    #                                        #
#                                                                             #
#                                                                             #
#                                                                             #
#                                                                             #
#                                                                             #
#                                                                             #
#                                                                             #
#                                                                             #
#                                                                             #
#                                                                             #
#                                                                             #
##########################################################        #############