###############################################################################
#                                                                             #
#                                                                             #
#                                                                             #
#############################################                                 #
                                            #                                 #
                                            #                                 #
                                            #                                 #
#                                           ##################   ##############
#                                           #                                 #
#                                           #                                 #
#                                           #                                 #
###################                         #                                 #
#                 #                         #                                 #
#                 #                         #                                 #
#                 ###########################                                 #
#                 #                                                           #
#                 #                                                           #
#                                                                             #
#                 #                                                           #
#                 #                                                           #
                  #                                                           #
#                 #                                                           #
#                 #                                                           #
###############################################################################